/computer/programming_language/influenced_by	0
/government/politician/government_positions_held./government/government_position_held/jurisdiction_of_office	1
/location/location/people_born_here	2
/location/location/street_address./location/mailing_address/citytown	3
/location/location/street_address./location/mailing_address/state_province_region	4
/location/location/time_zones	5
/location/neighborhood/neighborhood_of	6
/location/place_with_neighborhoods/neighborhoods	7
/location/statistical_region/gdp_nominal./measurement_unit/dated_money_value/currency	8
/location/statistical_region/gdp_nominal_per_capita./measurement_unit/dated_money_value/currency	9
/location/statistical_region/gdp_real./measurement_unit/adjusted_money_value/adjustment_currency	10	
/medicine/disease/includes_diseases	11
/music/group_member/membership./music/group_membership/group	12
/music/group_member/membership./music/group_membership/role	13
/olympics	/olympic_games/athletes./olympics/olympic_athlete_affiliation/country	14
/olympics	/olympic_athlete/country./olympics/olympic_athlete_affiliation/sport	15
/olympics/olympic_athlete/country./olympics/olympic_athlete_affiliation/country	16	
/olympics/olympic_athlete/country./olympics/olympic_athlete_affiliation/olympics	17	
/olympics/olympic_athlete/country./olympics/olympic_athlete_affiliation/sport	18
/olympics/olympic_athlete/medals_won./olympics/olympic_medal_honor/country	19
/olympics/olympic_athlete/medals_won./olympics/olympic_medal_honor/medal	20
/olympics/olympic_athlete/medals_won./olympics/olympic_medal_honor/medalist	21	
/olympics/olympic_athlete/medals_won./olympics/olympic_medal_honor/olympics	22
/olympics/olympic_games/athletes./olympics/olympic_athlete_affiliation/athlete	23
/olympics/olympic_games/athletes./olympics/olympic_athlete_affiliation/country	24
/olympics/olympic_participating_country/athletes./olympics/olympic_athlete_affiliation/athlete	25	
/olympics/olympic_participating_country/athletes./olympics/olympic_athlete_affiliation/olympics	26
/people/appointed_role/appointment./people/appointment/appointed_by	27
/people/person/nationality	28
/time/event/locations	29
/tv/tv_program/regular_cast./tv/regular_tv_appearance/character	30
/tv/tv_series_episode/guest_stars./tv/tv_guest_role/actor	31
/user/jg/default_domain/olympic_games/sports	32
/architecture/structure/address./location/mailing_address/citytown	33
/base/popstra/religion/membership./base/popstra/religion_choice/member	34
/common/topic/webpage./common/webpage/category	35